All-purpose flour – King Arthur
Granulated sugar – Domino
Brown sugar – C&H
Baking soda – Arm & Hammer
Baking powder – Clabber Girl
Cornstarch – Argo
Table salt – Morton
Black pepper – McCormick
Olive oil – Bertolli
Vegetable oil – Wesson
Honey – Nature Nate’s
Maple syrup – Pearl Milling Company
Peanut butter – Jif
Chocolate-hazelnut spread – Nutella
Spaghetti – Barilla
Brown rice – Lundberg
Quinoa – Bob’s Red Mill
Old-fashioned oats – Quaker
Dry black beans – Goya
Canned pinto beans – Bush’s
Canned diced tomatoes – Hunt’s
Tomato paste – Contadina
Tomato sauce – Ragu
Canned tuna – StarKist
Canned chicken – Swanson
Chicken broth – College Inn
Beef broth – Pacific Foods
Vegetable broth – Imagine
Saltine crackers – Premium
Breakfast cereal – Cheerios (General Mills)
Granola bars – Nature Valley
Popcorn kernels – Orville Redenbacher’s
Microwave popcorn – Pop Secret
Instant noodles – Maruchan Ramen
Soy sauce – Kikkoman
Worcestershire sauce – Lea & Perrins
Hot sauce – Tabasco
White vinegar – Heinz
Apple cider vinegar – Bragg
Dried basil – McCormick
Ground cinnamon – Badia
Black tea bags – Lipton
Ground coffee – Folgers
Instant coffee – Nescafé
Drink mix powder – Country Time Lemonade
Sweetened condensed milk – Eagle Brand
Evaporated milk – Carnation
Shelf-stable almond milk – Almond Breeze
Semi-sweet chocolate chips – Nestlé Toll House
Cocoa powder – Hershey’s